XXXXXXXXXXXXXXXXXXXXXXXXXXXXXXXEXXXXXXXXXXXXXXXXXX
XXE     1                                       XX
XXX                                             XX
XXX                                             XX
XXXXXXXXEXXXXXXX           XXEXXXXXXXXXXXXXXXXXXXX
XXXXXXXXXXXXXXXX           XXXXXXXXXXXXXXXXXXXXXXX
XXXXXXXXXXXXXXXX           XXXXXXXXXXXXXXXXXXXXXXX
XXXXXXXXXXXXXXXX           XXXXXXXXXXXXXXXXXXXXXXX
XXXXXXXXXXXXXXXX           XXXXXXXXXXXXXXXXXXXXXXX
XXXXXXXXXXXXXXXX           XXXXXXXXXXXXXXXXXXXXXXX
XXXXXXXXXXXXXXXX           XXXXXXXXXXXXXXXXXXXXXXX
XXXXXXXXXXXXXXXX           XXXXXXXXXXXXXXXXXXXXXXX
XXXXXXXXXXXXXXXX           XXXXXXXXXXXXXXXXXXXXXXX
XXXXXXXXXXXXXXXX                              XXXX
XXXXXXXXXXXXXXXX                              XXXX
XXXXXXXXXXXXXXXX                              XXXX
XXXXXXXXXXXXXXXX            C TXX             XXXX
XXXXXX                        XXX    XXXXX    XXXX
XXXXXE                      C XXX    XXXXX    XXXX
XXXXXX                        XXX    XXXXX    XXXX
XXXXXX                      C XXX    XXXXX    XXXX
XXXXXX                        XXX    XXXXX    XXXX
XXXXXX                               XXXXX    XXXX
XXXXXE                               XXXXX    XXXX
XXXXXX 0                         2            XXXX
XXXXXXXXXXXXXXXX           XXXXXXXXXXXXXXXXXXXXXXX
XXXXXXXXXXXXXXXX           XXXXXXXXXXXXXXXXXXXXXXX
XXXXXXXXXXXXXXXX           XXXXXXXXXXXXXXXXXXXXXXX
XXXXXXXXXXXXXXXX           XXXXXXXXXXXXXXXXXXXXXXX
XXXXXXXXXXXXXXXX           XXXXXXXXXXXXXXXXXXXXXXX
XXXXXXXXXXXXXXXX           XXXXXXXXXXXXXXXXXXXXXXX
XXXXXXXXXXXXXXXX4          XXXXXXXXXXXXXXXXXXXXXXX
XXXXXXXXXXXXXXXX           XXXXXXXXXXXXXXXXXXXXXXX
XXXXXXXXXXXXXXXX           XXXXXXXXXXXXXXXXXXXXXXX
XXXXXXXXXXXXXXXX           XXXXXXXXXXXXXXXXXXXXXXX
XXXXXXXXXXXXXXXX           XXXXXXXXXXXXXXXXXXXXXXX
XXXXXXXXXXXXXXXX           XXXX^XXXXXXXXXXXXXXXXXX
XXXXXX                         M      XXXXXXXXXXXX
XXXXXX                                XXXXXXXXXXXX
XXXXX^   P                            XXXXXXXXXXXX
XXXXX^                                XXXXXXXXXXXX
XXXXX^                                XXXXXXXXXXXX
XXXXX^                                X         XX
XXXXXX                                X         XX
XXXXXX                                          XX
XXXXXX                                          XX
XX                                              XX
XX                                              XX
XX                                  3           XX
XXXXXXXXXXXXXXXXXXXXXXXXXXXXXXXXXXXXXXXXXXXXXXXXXX