XXXXXXXXXXXXXXXXXXXXXXXXXXXXXXX^XXXXXXXXXXXXXXXXX
XX^                                             X
XXX                                             X
XXX                                             X
XXXXXXXX^XXXXXXX           XX^XXXXXXXXXXXXXXXXXXX
XXXXXXXXXXXXXXXX           XXXXXXXXXXXXXXXXXXXXXX
XXXXXXXXXXXXXXXX           XXXXXXXXXXXXXXXXXXXXXX
XXXXXXXXXXXXXXXX           XXXXXXXXXXXXXXXXXXXXXX
XXXXXXXXXXXXXXXX           XXXXXXXXXXXXXXXXXXXXXX
XXXXXXXXXXXXXXXX                              XXX
XXXXXXXXXXXXXXXX                              XXX
XXXXXXXXXXXXXXXX                              XXX
XXXXXXXXXXXXXXXX              XXX             XXX
XXXXXX                        XXX    XXXXX    XXX
XXXXX^                        XXX    XXXXX    XXX
XXXXXX                        XXX    XXXXX    XXX
XXXXXX                        XXX    XXXXX    XXX
XXXXXX                        XXX    XXXXX    XXX
XXXXXX                               XXXXX    XXX
XXXXX^                               XXXXX    XXX
XXXXXX                                        XXX
XXXXXXXXXXXXXXXX           XXXXXXXXXXXXXXXXXXXXXX
XXXXXXXXXXXXXXXX           XXXXXXXXXXXXXXXXXXXXXX
XXXXXXXXXXXXXXXX           XXXXXXXXXXXXXXXXXXXXXX
XXXXXXXXXXXXXXXX           XXXXXXXXXXXXXXXXXXXXXX
XXXXXXXXXXXXXXXX           XXXXXXXXXXXXXXXXXXXXXX
XXXXXXXXXXXXXXXX           XXXXXXXXXXXXXXXXXXXXXX
XXXXXXXXXXXXXXXX           XXXXXXXXXXXXXXXXXXXXXX
XXXXXXXXXXXXXXXX           XXXX^XXXXXXXXXXXXXXXXX
XXXXXX                         P      XXXXXXXXXXX
XXXXXX                                XXXXXXXXXXX
XXXXX^                                XXXXXXXXXXX
XXXXX^                                XXXXXXXXXXX
XXXXX^                                XXXXXXXXXXX
XXXXX^                                X         X
XXXXXX                                X         X
XXXXXX                                          X
XXXXXX                                          X
XX                                              X
XX                                              X
XX                                              X
XXXXXXXXXXXXXXXXXXXXXXXXXXXXXXXXXXXXXXXXXXXXXXXXX