XXXXXXXXXXXXXXXXXXXXXXXXXXXXXXXEXXXXXXXXXXXXXXXXXX
XXE     1                                       XX
XXX                                             XX
XXX                                             XX
XXXXXXXXEXXXXXXX           XXEXXXXXXXXXXXXXXXXXXXX
XXXXXXXXXXXXXXXX           XXXXXXXXXXXXXXXXXXXXXXX
XXXXXXXXXXXXXXXX           XXXXXXXXXXXXXXXXXXXXXXX
XXXXXXXXXXXXXXXX           XXXXXXXXXXXXXXXXXXXXXXX
XXXXXXXXXXXXXXXX           XXXXXXXXXXXXXXXXXXXXXXX
XXXXXXXXXXXXXXXX           XXXXXXXXXXXXXXXXXXXXXXX
XXXXXXXXXXXXXXXX           XXXXXXXXXXXXXXXXXXXXXXX
XXXXXXXXXXXXXXXX           XXXXXXXXXXXXXXXXXXXXXXX
XXXXXXXXXXXXXXXX           XXXXXXXXXXXXXXXXXXXXXXX
XXXXXXXXXXXXXXXX                              XXXX
XXXXXXXXXXXXXXXX                              XXXX
XXXXXXXXXXXXXXXX                              XXXX
XXXXXXXXXXXXXXXX            C TZZ             XXXX
XXXXXX                        ZZZ    XXXXX    XXXX
XXXXXE                      C ZZZ    XXXXX    XXXX
XXXXXX                        ZZZ    XXXXX    XXXX
XXXXXX                      C ZZZ    XXXXX    XXXX
XXXXXX                        ZZZ    XXXXX    XXXX
XXXXXX                               XXXXX    XXXX
XXXXXE                               XXXXX    XXXX
XXXXXX 0                         2            XXXX
XXXXXXXXXXXXXXXX           XXXXXXXXXXXXXXXXXXXXXXX
XXXXXXXXXXXXXXXX           XXXXXXXXXXXXXXXXXXXXXXX
XXXXXXXXXXXXXXXX           XXXXXXXXXXXXXXXXXXXXXXX
XXXXXXXXXXXXXXXX           XXXXXXXXXXXXXXXXXXXXXXX
XXXXXXXXXXXXXXXX           XXXXXXXXXXXXXXXXXXXXXXX
XXXXXXXXXXXXXXXX           XXXXXXXXXXXXXXXXXXXXXXX
XXXXXXXXXXXXXXXX4          XXXXXXXXXXXXXXXXXXXXXXX
XXXXXXXXXXXXXXXX           XXXXXXXXXXXXXXXXXXXXXXX
XXXXXXXXXXXXXXXX           XXXXXXXXXXXXXXXXXXXXXXX
XXXXXXXXXXXXXXXX           XXXXXXXXXXXXXXXXXXXXXXX
XXXXXXXXXXXXXXXX           XXXXXXXXXXXXXXXXXXXXXXX
XXXXXXXXXXXXXXXX           XXXX^XXXXXXXXXXXXXXXXXX
XXXXXX                         M      XXXXXXXXXXXX
XXXXXX                                XXXXXXXXXXXX
XXXXX^   PZZ                          XXXXXXXXXXXX
XXXXX^   ZZZ                          XXXXXXXXXXXX
XXXXX^   ZZZ                          XXXXXXXXXXXX
XXXXX^   ZZZ                          X         XX
XXXXXX   ZZZ                          X         XX
XXXXXX   ZZZ                                    XX
XXXXXX                                          XX
XX                                              XX
XX                                              XX
XX                                  3           XX
XXXXXXXXXXXXXXXXXXXXXXXXXXXXXXXXXXXXXXXXXXXXXXXXXX